7
4 5 1 3 7 6 0
1 9 7 4 7 5 8
0 0 8 1 9 2 2
8 7 2 9 6 7 3
0 8 8 0 0 8 4
3 2 2 5 6 5 3
8 7 6 0 3 7 7
-1 -1

-1 -1 -1
-1 3 9
-1 -1 -1
1 2